##@@##
#@@@@#
@@@@@@
@@@@@@
@@##@@
@@@@@@
@@@@@@
#@@@@#
##@@##