##@##
#@@@#
@@@@@
@@@@@
@@@@@
@@@@@
@@@@@
#@@@#
##@##