@#@#@
@@@@@
@@@@@
@#@#@
@###@
@@#@@
@@@@@
@@@@@
@@@@@